5 10
|--------|
|..|.|.-.|
|..-|.@..|
|......-.|
|--------|