5 10
|--------|
|**|*|*-*|
|**-|*@**|
|******-*|
|--------|